{
    "id": 1,
    "name": "Level 1",
    "worldMap": [
        [8, 8, 8, 8, 8, 8, 8, 8, 8, 8, 8, 4, 4, 6, 4, 4, 6, 4, 6, 4, 4, 4, 6, 4],
		[8, 0, 0, 0, 0, 0, 0, 0, 0, 0, 8, 4, 0, 0, 0, 0, 0, 0, 0, 0, 0, 0, 0, 4],
		[8, 0, 3, 3, 0, 0, 0, 0, 0, 8, 8, 4, 0, 0, 0, 0, 0, 0, 0, 0, 0, 0, 0, 6],
		[8, 0, 0, 3, 0, 0, 0, 0, 0, 0, 0, 0, 0, 0, 0, 0, 0, 0, 0, 0, 0, 0, 0, 6],
		[8, 0, 3, 3, 0, 0, 0, 0, 0, 8, 8, 4, 0, 0, 0, 0, 0, 0, 0, 0, 0, 0, 0, 4],
		[8, 0, 0, 0, 0, 0, 0, 0, 0, 0, 8, 4, 0, 0, 0, 0, 0, 6, 6, 6, 0, 6, 4, 6],
		[8, 8, 8, 8, 0, 8, 8, 8, 8, 8, 8, 4, 4, 4, 4, 4, 4, 6, 0, 0, 0, 0, 0, 6],
		[7, 7, 7, 7, 0, 7, 7, 7, 7, 0, 8, 0, 8, 0, 8, 0, 8, 4, 0, 4, 0, 6, 0, 6],
		[7, 7, 0, 0, 0, 0, 0, 0, 7, 8, 0, 8, 0, 8, 0, 8, 8, 6, 0, 0, 0, 0, 0, 6],
		[7, 0, 0, 0, 0, 0, 0, 0, 0, 0, 0, 0, 0, 0, 0, 0, 8, 6, 0, 0, 0, 0, 0, 4],
		[7, 0, 0, 0, 0, 0, 0, 0, 0, 0, 0, 0, 0, 0, 0, 0, 8, 6, 0, 6, 0, 6, 0, 6],
		[7, 7, 0, 0, 0, 0, 0, 0, 7, 8, 0, 8, 0, 8, 0, 8, 8, 6, 4, 6, 0, 6, 6, 6],
		[7, 7, 7, 7, 0, 7, 7, 7, 7, 8, 8, 4, 0, 6, 8, 4, 8, 3, 3, 3, 0, 3, 3, 3],
		[2, 2, 2, 2, 0, 2, 2, 2, 2, 4, 6, 4, 0, 0, 6, 0, 6, 3, 0, 0, 0, 0, 0, 3],
		[2, 2, 0, 0, 0, 0, 0, 2, 2, 4, 0, 0, 0, 0, 0, 0, 4, 3, 0, 0, 0, 0, 0, 3],
		[2, 0, 0, 0, 0, 0, 0, 0, 2, 4, 0, 0, 0, 0, 0, 0, 4, 3, 0, 0, 0, 0, 0, 3],
		[1, 0, 0, 0, 0, 0, 0, 0, 1, 4, 4, 4, 4, 4, 6, 0, 6, 3, 3, 0, 0, 0, 3, 3],
		[2, 0, 0, 0, 0, 0, 0, 0, 2, 2, 2, 1, 2, 2, 2, 6, 6, 0, 0, 5, 0, 5, 0, 5],
		[2, 2, 0, 0, 0, 0, 0, 2, 2, 2, 0, 0, 0, 2, 2, 0, 5, 0, 5, 0, 0, 0, 5, 5],
		[2, 0, 0, 0, 0, 0, 0, 0, 2, 0, 0, 0, 0, 0, 2, 5, 0, 5, 0, 5, 0, 5, 0, 5],
		[1, 0, 0, 0, 0, 0, 0, 0, 0, 0, 0, 0, 0, 0, 0, 0, 0, 0, 0, 0, 0, 0, 0, 5],
		[2, 0, 0, 0, 0, 0, 0, 0, 2, 0, 0, 0, 0, 0, 2, 5, 0, 5, 0, 5, 0, 5, 0, 5],
		[2, 2, 0, 0, 0, 0, 0, 2, 2, 2, 0, 0, 0, 2, 2, 0, 5, 0, 5, 0, 0, 0, 5, 5],
		[2, 2, 2, 2, 1, 2, 2, 2, 2, 2, 2, 1, 2, 2, 2, 5, 5, 5, 5, 5, 5, 5, 5, 5]
    ],
    "player": {
        "position": [22.0, 12.0],
        "direction": [-1.0, 0.0]
    },
    "gameObjects": [
        {"type": "barrel", "position": [21.5, 1.5]},
        {"type": "barrel", "position": [15.5, 1.5]},
        {"type": "barrel", "position": [16.0, 1.8]},
        {"type": "barrel", "position": [16.2, 1.2]},
        {"type": "barrel", "position": [3.5, 2.5]},
        {"type": "barrel", "position": [9.5, 15.5]},
        {"type": "barrel", "position": [10.0, 15.1]},
        {"type": "barrel", "position": [10.5, 15.8]},

        {"type": "pillar", "position": [18.5, 10.5]},
        {"type": "pillar", "position": [18.5, 11.5]},
        {"type": "pillar", "position": [18.5, 12.5]},

		{"type": "turret", "position": [19.5, 1.5]}
    ]
}